0 0 0 0 0 0 0 0 0 0 0 0 0 0 0 0 0 0 0 0 0
0 0 0 0 0 0 0 0 0 0 0 0 0 0 0 0 0 0 0 0 0
0 0 0 26 27 12 12 12 12 12 12 12 12 13 14 0 0 0 0 0 0
0 0 0 25 9 3 3 3 3 3 3 3 3 6 15 0 0 0 0 0 0
0 0 0 24 5 10 10 10 10 0 12 13 14 5 16 0 0 0 0 0 0
0 0 0 24 5 16 0 0 0 0 0 0 15 5 10 12 13 14 0 0 0
0 0 0 24 5 16 0 0 0 0 0 0 16 8 3 3 6 15 0 0 0
0 0 0 24 5 16 0 0 0 0 0 0 10 12 13 14 5 16 0 0 0
0 0 0 24 5 16 0 0 0 0 0 0 0 0 0 15 5 16 0 0 0
0 0 0 24 5 10 12 12 12 12 12 12 13 14 0 16 5 16 0 0 0
0 0 0 24 5 9 3 3 3 3 3 3 6 15 0 17 5 16 0 0 0
0 0 0 23 8 7 0 0 20 20 20 10 5 10 20 18 5 16 0 0 0
0 0 0 22 21 19 18 10 10 0 0 23 8 3 3 3 7 17 0 0 0
0 0 0 0 0 0 0 0 0 0 0 22 21 20 20 20 19 18 0 0 0
0 0 0 0 0 0 0 0 0 0 0 0 0 0 0 0 0 0 0 0 0
0 0 0 0 0 0 0 0 0 0 0 0 0 0 0 0 0 0 0 0 0