0 0 0 0 0 0 0 0 0 0 0 0 0 0 0 0 0 0 0 0 0
0 0 0 0 0 0 0 0 0 0 0 0 0 0 0 0 0 0 0 0 0
0 0 0 0 0 0 0 0 0 0 0 0 0 0 0 0 0 0 0 0 0
0 0 0 0 9 3 3 3 3 3 3 3 3 6 0 0 0 0 0 0 0
0 0 0 0 5 10 10 10 10 0 0 0 0 5 0 0 0 0 0 0 0
0 0 0 0 5 0 0 0 0 0 0 0 0 5 10 0 0 0 0 0 0
0 0 0 0 5 0 0 0 0 0 0 0 0 8 3 3 6 0 0 0 0
0 0 0 0 5 0 0 0 0 0 0 0 10 0 0 0 5 0 0 0 0
0 0 0 0 5 0 0 0 0 0 0 0 0 0 0 0 5 0 0 0 0
0 0 0 0 5 10 0 0 0 0 0 0 0 0 0 0 5 0 0 0 0
0 0 0 0 5 9 3 3 3 3 3 3 6 0 0 0 5 0 0 0 0
0 0 0 0 8 7 0 0 0 0 0 10 5 10 0 0 5 0 0 0 0
0 0 0 0 0 0 0 10 10 0 0 0 8 3 3 3 7 0 0 0 0
0 0 0 0 0 0 0 0 0 0 0 0 0 0 0 0 0 0 0 0 0
0 0 0 0 0 0 0 0 0 0 0 0 0 0 0 0 0 0 0 0 0
0 0 0 0 0 0 0 0 0 0 0 0 0 0 0 0 0 0 0 0 0