0 0 0 0 0 0 0 0 0 0 0 0 0 0 0 0 0 0 0 0 0
0 0 0 0 0 0 0 0 0 0 0 0 0 0 0 0 0 0 0 0 0
0 0 0 26 27 12 12 12 12 12 12 12 12 13 14 0 0 0 0 0 0
0 0 0 25 9 3 3 3 3 3 3 3 3 6 15 0 0 0 0 0 0
0 0 0 24 5 0 10 10 10 10 12 13 14 5 23 0 0 0 0 0 0
0 0 0 24 5 16 0 0 0 0 0 0 15 5 22 21 13 14 0 0 0
0 0 0 24 5 16 0 0 0 0 0 0 23 8 3 3 6 15 0 0 0
0 0 0 24 5 16 0 0 0 0 0 0 22 21 15 14 5 16 0 0 0
0 0 0 24 5 23 0 0 0 0 0 0 0 0 0 15 5 16 0 0 0
0 0 0 24 5 22 21 12 12 12 12 12 13 14 0 16 5 16 0 0 0
0 0 0 24 5 9 3 3 3 3 3 3 6 15 0 17 5 16 0 0 0
0 0 0 23 8 7 26 27 20 20 20 14 5 22 12 18 5 16 0 0 0
0 0 0 22 21 19 18 0 0 0 0 23 8 3 3 3 7 17 0 0 0
0 0 0 0 0 0 0 0 0 0 0 22 21 20 20 20 19 18 0 0 0
0 0 0 0 0 0 0 0 0 0 0 0 0 0 0 0 0 0 0 0 0
0 0 0 0 0 0 0 0 0 0 0 0 0 0 0 0 0 0 0 0 0