-1 -1 -1 -1 -1 -1 -1 -1 -1 -1 -1 -1 -1 -1 -1 -1 -1 -1 -1 -1 -1
-1 -1 -1 -1 -1 -1 -1 -1 -1 -1 -1 -1 -1 -1 -1 -1 -1 -1 -1 -1 -1
-1 -1 -1 26 27 12 12 12 12 12 12 12 12 13 14 -1 -1 -1 -1 -1 -1
-1 -1 -1 25 -1 -1 -1 -1 -1 -1 -1 -1 -1 -1 15 -1 -1 -1 -1 -1 -1
-1 -1 -1 24 -1 -1 -1 -1 -1 -1 12 13 14 -1 16 -1 -1 -1 -1 -1 -1
-1 -1 -1 24 -1 16 -1 -1 -1 -1 -1 -1 15 -1 -1 12 13 14 -1 -1 -1
-1 -1 -1 24 -1 16 -1 -1 -1 -1 -1 -1 16 -1 -1 -1 -1 15 -1 -1 -1
-1 -1 -1 24 -1 16 -1 -1 -1 -1 -1 -1 -1 12 13 14 -1 16 -1 -1 -1
-1 -1 -1 24 -1 16 -1 -1 -1 -1 -1 -1 -1 -1 -1 15 -1 16 -1 -1 -1
-1 -1 -1 24 -1 -1 12 12 12 12 12 12 13 14 -1 16 -1 16 -1 -1 -1
-1 -1 -1 24 -1 -1 -1 -1 -1 -1 -1 -1 -1 15 -1 17 -1 16 -1 -1 -1
-1 -1 -1 23 -1 -1 -1 -1 20 20 20 -1 -1 -1 20 18 -1 16 -1 -1 -1
-1 -1 -1 22 21 19 18 -1 -1 -1 -1 23 -1 -1 -1 -1 -1 17 -1 -1 -1
-1 -1 -1 -1 -1 -1 -1 -1 -1 -1 -1 22 21 20 20 20 19 18 -1 -1 -1
-1 -1 -1 -1 -1 -1 -1 -1 -1 -1 -1 -1 -1 -1 -1 -1 -1 -1 -1 -1 -1
-1 -1 -1 -1 -1 -1 -1 -1 -1 -1 -1 -1 -1 -1 -1 -1 -1 -1 -1 -1 -1